1111111111
1010000001
1010000001
1011110001
1010010001
1000000001
1000000001
1000000001
1000000001
1111111111